bbs.flyme.cn	科技
www.zybang.com	教育
detail.mall.meizu.com	科技
m.meizu.com	科技
m.120ask.com	健康
muzhi.baidu.com	健康
show.v.meizu.com	科技
baobao.baidu.com	育儿
m.ctrip.com	旅游
3g.club.xywy.com	健康
bbs.meizu.cn	科技
m.haodf.com	健康
www.flyme.cn	科技
h5.qichedaquan.com	汽车
m.babytree.com	育儿
i.flyme.cn	科技
m.flyme.cn	科技
mall.meizu.com	科技
a.9game.cn	游戏
car.h5.yiche.com	汽车
m.anjuke.com	房产
login.flyme.cn	科技
club.m.autohome.com.cn	汽车